*************************
*************************
*************************
********############*****
*************************
*************************
*****#****************#**
*****#****************#**
*****#****************#**
*****#****************#**
*****#****************#**
*****#****************#**
**********************#**
*******############******
*************************
*************************
*************************
*************************
*************************
*************************
*************************
*************************
*************************
*************************
*************************